15 52
====================================================
= $ Treasure!                                      =
====                                               =
=                                                  =
=                                                  =
=     You can move with WSAD                       =
=                                                  =
=                                                  =
=                               =   This is wall   =
=                               =                  =
=                               =                  =
=                       Mine!  @=                  =
=                               =                  =
=                               =       Finish #   =
====================================================

P 1 13