20 80
================================================================================
=$        =  =       =      =        =  =    =@       =             =   $ =    =
= ==== ====  = ====     =       =          = =====  ======== ===    =       @  =
=@=  =    =  = ====  ======================= @  $   =          =  === =@=====  =
= = ===== =       =  @      =  =       = @ ===== =  =   ========        =      =
=                 =  = ==== =  =  ======   =  =  =  =   =      =@=@====== ==@===
=== === ==== ======  = =    =     =        =  = @=  =   ===  = = = =   =       =
=   = =   $= =  =    = = =@==  =  = = = =  =  =  =  =        = = = = = =====@= =
===== =@ === =     =   =       =    =   =        =  ========== = = = = =       =
=  =  =      ===== =======  ==@=   ====== ========             = =   = = ===@===
=     @  === =       =   =  =  =   =    =        ===================== =       =
= ======== = =   = =   =    =  =  == == ========  =   $              = =====@= =
=     =    = =========@============   = =      ====== ====  ======== = =       =
=====   =  = =       =            = # = = ==== =  =   =  ==  ==    === = ===@===
=   = ===  = = =  =  =   = =====  =   = = =  = =  =  @=   ==  ==   =           =
=== =   ====   =  ====   = @     === == = ==== =  =   =   ===  === =   =====@= =
=     $      = =         === =     = =         =  =@@ =   = ==   === ===       =
=   ======================== ======= =  ========  =   =  $=  ==    =   = ===@===
=                          @         =                        =@$@     =       =
================================================================================

P 3 7